агентом | агент
агрономши | агрономша
агрономшу | агрономша
академики | академик
аккомпаниатором | аккомпаниатор
актера | актер
актер | актер
актеры | актер
активистом | активист
акционером | акционер
американского медиамагната | американский медиамагнат
американского нейробиолога | американский нейробиолог
американского посла | американский посол
американского социального психолога | американский социальный психолог
аналитик | аналитик
артист | артист
артисту | артист
барабанщиком | барабанщик
бармена | бармен
бегун | бегун
белорусским лидером | белорусский лидер
бизнесмен | бизнесмен
бизнесменом | бизнесмен
бизнесмены | бизнесмен
блогера | блогер
богини | богиня
боливийский президент | боливийский президент
британского исполнителя | британский исполнитель
бывшему владельцу | бывший владелец
бывшему художественному руководителю | бывший художественный руководитель
бывший вице-президент | бывший вице-президент
бывший гендиректор | бывший гендиректор
бывший журналист | бывший журналист
бывший заместитель министра | бывший заместитель министра
бывший заместитель министра внутренних дел | бывший заместитель министра внутренних дел
бывший редактор | бывший редактор
бывший руководитель | бывший руководитель
бывший совладелец | бывший совладелец
бывший чемпион по борьбе | бывший чемпион по борьбе
бывшим госсекретарем | бывший госсекретарь
бывшим зампредседателя | бывший зампредседатель
ведущий | ведущий
великий комбинатор | великий комбинатор
великий режиссёр | великий режиссёр
венесуэльский лидер | венесуэльский лидер
ви-джеи | ви-джей
вице-президента | вице-президент
вице-президент | вице-президент
вице-президентом | вице-президент
вице-премьера | вице-премьер
вице-премьер | вице-премьер
вице-премьером | вице-премьер
владельцу | владелец
врио мэра | врио мэр
гендиректора | гендиректор
гендиректор | гендиректор
гендиректором | гендиректор
гендиректору | гендиректор
генерала | генерал
генерального директора | генеральный директор
генеральный прокурор | генеральный прокурор
генеральным директором | генеральный директор
генпрокурор | генпрокурор
генпрокурору | генпрокурор
генсека | генсек
генсек | генсек
генсеком | генсек
германским продюсером | германский продюсер
глава государства | глава государства
главе | глава
главного комментатора | главный комментатор
главного редактора | главный редактор
главном редакторе | главный редактор
главный исполнительный директор | главный исполнительный директор
главный редактор | главный редактор
главный русский шансонье | главный русский шансонье
главный санитарный врач | главный санитарный врач
главным редактором | главный редактор
главой государства | глава государства
главреда | главред
главред | главред
главредом | главред
главреду | главред
главы государств | глава государства
голливудского актера | голливудский актер
горничная | горничная
госсекретарем | госсекретарь
госсекретаря | госсекретарь
графа | граф
дантист | дантист
депутатов | депутат
депутату | депутат
депутат - эсер | депутат - эсер
детектив | детектив
дизайнером | дизайнер
дипломата | дипломат
директора по развитию | директор по развитию
директором | директор
директором по маркетингу | директор по маркетингу
директор по внешним коммуникациям | директор по внешним коммуникациям
директор по оценке и реализации лотов | директор по оценке и реализации лотов
дирижер | дирижер
дирижером | дирижер
доктор искусствоведения | доктор искусствоведения
замгендиректора | замгендиректора
заместителем министра обороны | заместитель министра обороны
заместитель директора | заместитель директора
заместитель министра внутренних дел | заместитель министра внутренних дел
заместитель министра | заместитель министра
заместитель министра обороны | заместитель министра обороны
заместитель председателя | заместитель председателя
заместитель руководителя | заместитель руководителя
заместителями министра иностранных дел | заместитель министра иностранных дел
заместителя шеф-редактора | заместитель шеф-редактора
замминистра связи | замминистра связи
замминистра сельского хозяйства | замминистра сельского хозяйства
зампред | зампред
зампредседателя | зампредседателя
заслуженный артист | заслуженный артист
звукорежиссер | звукорежиссер
идеалист | идеалист
инженером | инженер
исполнитель | исполнитель
исполнительного директора | исполнительный директор
исполнительный директор | исполнительный директор
исполнителя | исполнитель
исследовательница | исследовательница
итальянского премьера | итальянский премьер
канадского психолога | канадский психолог
кандидата в мэры | кандидат в мэры
кандидат в мэры | кандидат в мэры
кандидат | кандидат
кандидат от демократических сил | кандидат от демократических сил
канцлера | канцлер
канцлер | канцлер
канцлером | канцлер
кардинал | кардинал
кинорежиссер | кинорежиссер
кинорежиссером | кинорежиссер
клавишник | клавишник
князь | князь
командующий | командующий
командующий объединенными силами альянса в европе | командующий объединенными силами альянса в европе
командующий объединенными силами альянса | командующий объединенными силами альянса
комбинатор | комбинатор
комментатора | комментатор
композитора | композитор
консультантом | консультант
концертирующего пианиста | концертирующий пианист
корреспондента | корреспондент
корреспондент | корреспондент
куратор | куратор
лауреат | лауреат
лидеры | лидер
лидеры самопровозглашенных донецкой и луганской народных республик | лидеры самопровозглашенных донецкой и луганской народных республик
литератора | литератор
мастер | мастер
медиамагната | медиамагнат
медиамагнат | медиамагнат
менеджером | менеджер
менеджером по продукции | менеджер по продукции
миллиардеру | миллиардер
министра внутренних дел | министр внутренних дел
министра по делам объединения кореи | министр по делам объединения кореи
министр здравоохранения | министр здравоохранения
министр обороны | министр обороны
министр образования и науки | министр образования и науки
министров иностранных дел | министр иностранных дел
министров | министр
министром иностранных дел | министр иностранных дел
министром природных ресурсов и экологии | министр природных ресурсов и экологии
министр связи и массовых коммуникаций | министр связи и массовых коммуникаций
министр сельского хозяйства | министр сельского хозяйства
министр спорта | министр спорта
митрополит | митрополит
монаху | монах
монгольского президента - демократа | монгольский президент - демократ
московским школьником | московский школьник
музыкальный обозреватель | музыкальный обозреватель
музыкальным руководителем | музыкальный руководитель
музыкант | музыкант
музыковед | музыковед
мученицы | мученица
мэром | мэр
народному депутату | народный депутат
народный артист | народный артист
народным артистом | народный артист
народным артистом ссср | народный артист ссср
научный сотрудник | научный сотрудник
начальник | начальник
независимый директор | независимый директор
нейробиолога | нейробиолог
нынешний глава | нынешний глава
обозреватель | обозреватель
одесской шансоньетки | одесская шансоньетка
оппозиционера | оппозиционер
оппозиционер | оппозиционер
оппозиционеру | оппозиционер
основателей компании | основатель компании
основателю дзен | основатель дзен
основоположник импрессионизма | основоположник импрессионизма
отечественного писателя | отечественный писатель
патриарх московский и всея руси | патриарх московский и всея руси
патриарх московский | патриарх московский
патриархом | патриарх
патриарх | патриарх
певицы | певица
первый вице-президент | первый вице-президент
первый вице-премьер | первый вице-премьер
первый замгендиректора | первый замгендиректора
первый заместитель гендиректора | первый заместитель гендиректора
первый заместитель | первый заместитель
первый заместитель председателя госдумы по международным делам | первый заместитель председателя госдумы по международным делам
первый заместитель руководителя | первый заместитель руководителя
первый зампред | первый зампред
первым барабанщиком | первый барабанщик
переводчик | переводчик
пианиста | пианист
пианист | пианист
писательница | писательница
писательницы | писательница
писателю | писатель
политику | политик
политолог | политолог
политтехнолога | политтехнолог
полноправным владельцем | полноправный владелец
помощника госсекретаря | помощник госсекретаря
помощник главы | помощник главы
помощник президента | помощник президента
помощник редактора | помощник редактора
помощницы | помощница
посол россии на украине | посол россии на украине
посол россии | посол россии
посол рф по особым поручениям | посол рф по особым поручениям
постоянный представитель | постоянный представитель
постоянный представитель сша при оон | постоянный представитель сша при оон
почетным президентом | почетный президент
предводителя | предводитель
предпринимателя | предприниматель
председателем | председатель
представители | представитель
представитель сша при оон | представитель сша при оон
представителя | представитель
президента - демократа | президент - демократ
президентами | президент
президентский помощник | президентский помощник
президенты | президент
премьером | премьер
пресс-секретарь президента | пресс-секретарь президента
пресс-секретарь | пресс-секретарь
пресс-секретарь управделами президента | пресс-секретарь управделами президента
пресс-секретарю президента | пресс-секретарь президента
пресс-секретарю | пресс-секретарь
пресс-секретаря | пресс-секретарь
продюсером | продюсер
прокурор | прокурор
проректор по международному сотрудничеству | проректор по международному сотрудничеству
проректор | проректор
профессор | профессор
прыгунья в длину | прыгунья в длину
психолога | психолог
разработчика интернет-проектов | разработчик интернет-проектов
редактора | редактор
редактором | редактор
режиссера | режиссер
режиссер | режиссер
российский министр иностранных дел | российский министр иностранных дел
российский переводчик | российский переводчик
российским президентом | российский президент
российского лидера | российский лидер
российскому миллиардеру | российский миллиардер
российскому сенатору | российский сенатор
руководителем | руководитель
руководителю | руководитель
руководителя | руководитель
русский шансонье | русский шансонье
санитарный врач | санитарный врач
священника | священник
сенатору | сенатор
силач | силач
советника | советник
советник губернатора | советник губернатора
советник | советник
совладельца | совладелец
совладельцем | совладелец
совладельцу | совладелец
создатель мессенджера | создатель мессенджера
солдат | солдат
сооснователь | сооснователь
сопредседателя | сопредседатель
сотрудник | сотрудник
социального психолога | социальный психолог
специалист по демографии | специалист по демографии
специалист по экономике и демографии | специалист по экономике и демографии
специалист | специалист
специальный представитель президента россии по международному сотрудничеству в арктике и антарктике | специальный представитель президента россии по международному сотрудничеству в арктике и антарктике
спецпредставитель президента рф по международному сотрудничеству в арктике и антарктике | спецпредставитель президента рф по международному сотрудничеству в арктике и антарктике
старший директор | старший директор
старший корреспондент | старший корреспондент
старший научный сотрудник | старший научный сотрудник
старший юрист практики внешней торговли и таможенного права | старший юрист практики внешней торговли и таможенного права
старший юрист | старший юрист
статистом | статист
судьи | судья
творческим консультантом | творческий консультант
ударником | ударник
украинский лидер | украинский лидер
украинский президент | украинский президент
украинской певицы | украинская певица
управделами президента | управделами президента
участницам | участница
участниц | участница
участницы | участница
ученый | ученый
учителей | учитель
учредителями | учредитель
физик | физик
финансовый директор | финансовый директор
французским президентом | французский президент
хозяину ещё двух радиостанций | хозяин ещё двух радиостанций
художественному руководителю | художественный руководитель
художественный руководитель | художественный руководитель
художника | художник
художник | художник
частный детектив | частный детектив
чемпион по борьбе | чемпион по борьбе
черногорского президента | черногорский президент
чиновника | чиновник
читательницы | читательница
шансоньетки | шансоньетка
шансонье | шансонье
шеф-редактора | шеф-редактор
школьником | школьник
экс-госсекретарь | экс-госсекретарь
эксперты рынка | эксперт рынка
эксперт | эксперт
экс-президент | экс-президент
экс-премьер | экс-премьер
экс-худрука | экс-худрук
юрист практики внешней торговли и таможенного права | юрист практики внешней торговли и таможенного права
юрист | юрист
японский идеалист | японский идеалист
японский писатель | японский писатель
японский премьер | японский премьер
японского литератора | японский литератор
японского чиновника | японский чиновник
